NO ./textures/seamless_1.png
SO ./textures/seamless_1.png
WE ./textures/seamless_1.png
EA ./textures/seamless_1.png

F 220,200,0
C 225,30,0

11111111111111111111111111111
10000000000000000000000000011
10000000000000100000000000001
100000000000001000000N0000001
11111111111111100000000000001111111111111111111111111111111
10000000000000000000000000000000000000000000000000000000001
10000000000000000000000000000000000000000000000000000000001
10000000000000000000000000000000000000000000000000000000001
10000000000000000000000000000000000000000000000000000000001
11111111111111111111111111111111111111111111111111111111111