NO ./textures/seamless_tile1.png
SO ./textures/seamless_tile1.png
WE ./textures/space_18.png
EA ./textures/space_18.png

F 000,005,53
C 0,0,255

11111111111111111111111111111111111111111111111111111111111
10000000000000000000000000000000000000000000000000000000001
10000000000000000000000000000000000000000000000000000000001
10000000001111111111111111111111111111111111111110000000001
10000000001                                     10000000001
10000000001                                     10000000001
10000000001                                     10000000001
10000000001                                     10000000001
10000000001111111111111111111111111111111111111110000000001
10000000000000000000000000000000000000000000000000000000001
10000000001111111111111111111111111111111111111110000000001
10000000001                                     10000000001
10000000001                                     10000000001
10000000001                                     10000000001
10000000001111111111111111111111111111111111111110000000001
10000000000000000000000000000000000000000000000000000000001
10000000000000000000000000000000000000000000000000000000N01
11111111111111111111111111111111111111111111111111111111111