NO ./textures/ocean.png
SO ./textures/ocean.png
WE ./textures/ocean.png
EA ./textures/ocean.png

F 120,200,0
C 125,30,0

11111
10001
10001
10N01
11111