NO ./textures/seamless_1.png
SO ./textures/seamless_1.png
WE ./textures/seamless_3.png
EA ./textures/seamless_3.png

F 220,200,0
C 225,30,0

111111111111111
100000000000001
100000000000001
100N00010000001
111111111111111