NO ./textures/seamless_1.png
SO ./textures/seamless_1.png
WE ./textures/seamless_3.png
EA ./textures/seamless_3.png

F 149,200,0
C 125,30,0

        1111111111111111111111111
        1000000000110000000000001
        1011000001110000000000001
        1001000000000000000N00001
111111111011000001110000000000001
100000000000000001110111111111111 
11110111111111011100000010001
11110111111111011101010010001
11000000110101011100000010001
10000000000000000000000000001
10000000000000000001010010001
11000001110101011111111110001111111111111
11110111 1110101 100000000000000000000001
11111111111111111111111111111111111111111