NO ./textures/seamless_tile1.png
SO ./textures/space_4.png
WE ./textures/space_18.png
EA ./textures/space_18.png

F 100,57,0
C 0,0,0

1111111111111111111
1000001000000000001
1011101011111011101
1010001010001010001
1010111010101010111
1010100010101000001
1010101110101111101
1010000000101000101
1011111110101110101
1000000010100010101
1111111010111010101
100000N010001010001
1011111110101011111
1010000000101000001
1010111111101111101
1000100000000000101
1110101111111110101
1000101000000010001
1111111111111111111